#################################################################################################
#                                                                                               #
#                                                                                               #
#                                                                                               #
#                                                                                               #
#            ##########################                      #                                  #
#                                                            #                                  #
#                                                            #                                  #
#                                                            #                                  #
#                                                            #                                  #
#                                                            #                                  #
#                                                            #                                  #
#                                                            #                                  #
#                                          *                 #                                  #
#                                                            #                                  #
#                                                            #                                  #
#                                                            #                                  #
#                                                            #######################            #
#                                                                                               #
#                                                                                               #
#                                                                                               #
#                                                                                               #
#                                                                                               #
#                                                                                               #
#                                                                                               #
#################################################################################################