###########################################################################################
#################### ##############             ####     ##################################
######                 ############ ########### ####                                      ~
####### ### ########## ############ ########### ####     ##################################
####### ### ########## ############ ###         ####     ##################################
####### ### ########## ############ ### ############     ##################################
####### ### ########## ################ ############     ##################################
####### ### ##########    *                                         #######################
####### ### ########## ########## ########################### #############################
####### ### ########## ########## ########################### #############################
####### ### ##################### ########################### #############################
####### ###                 ##### ###########################                       #######
####### ### ##################### #####          ############ ############ ################
####### ######################### ##### ######## ######################### ################
####### ######                    ##### ######## ######################### ################
####### ######### ############### ##### ######## ######################### ################
####### ######### ####    ####### ##### ######## ######################### ################
################# ####### ####### ##### ######## #########################              ###
#################          ###### ##### #####                              ################
######            ### ########### ##### ############ ##################### ################
################# ############### ##### ############      #################################
###########################################################################################